0000000000
0000000000
0000100000
0000100000
0001110000
0001110000
0000100000
0000100000
0000000000
0000000000
