0000000000
0000000000
0000011000
0000110000
0000010000
0000000000
0000000000
0000000000
0000000000
0000000000
