0000000000
0001001000
0001110000
0001110000
0000010000
0000100000
0001010000
0010001000
0000000000